%%%%%%%
% G   %
% %%% %
% %.  %
% %%% %
%     %
%     %
%     %
%     %
%     %
%     %
%     %
%     %
%     %
%     %
%     %
%     %
%     %
%     %
%     %
%  P  %
%     %
%  G  %
%%%%%%%
